Player,Pos,G,MP,FG,FGA,FG%,3P,3PA,3P%,2P,2PA,2P%,eFG%,FT,FTA,FT%,ORB,DRB,TRB,AST,STL,BLK,TOV,PF,PTS
Steven Adams,C,58,1605,189,308,0.614,0,3,0,189,305,0.62,0.614,60,135,0.444,213,301,514,111,54,38,78,113,438
Bam Adebayo,C,64,2143,456,800,0.57,2,8,0.25,454,792,0.573,0.571,283,354,0.799,142,431,573,346,75,66,169,145,1197
LaMarcus Aldridge,C,26,674,140,296,0.473,31,80,0.388,109,216,0.505,0.525,41,47,0.872,19,99,118,49,11,29,27,47,352
Jarrett Allen,C,63,1864,298,482,0.618,6,19,0.316,292,463,0.631,0.624,204,290,0.703,196,435,631,106,32,90,100,96,806
Deandre Ayton,C,69,2115,430,687,0.626,4,20,0.2,426,667,0.639,0.629,133,173,0.769,228,499,727,99,41,81,103,196,997
Udoka Azubuike,C,15,57,4,9,0.444,0,0,,4,9,0.444,0.444,8,10,0.8,4,9,13,0,1,4,3,9,16
Mo Bamba,C,46,725,142,301,0.472,38,118,0.322,104,183,0.568,0.535,45,66,0.682,76,189,265,35,14,58,36,87,367
Aron Baynes,C,53,980,134,304,0.441,27,103,0.262,107,201,0.532,0.485,29,41,0.707,87,186,273,47,17,23,46,119,324
Jordan Bell,C,6,82,7,22,0.318,0,2,0,7,20,0.35,0.318,1,2,0.5,7,17,24,7,3,5,4,7,15
Khem Birch,C,67,1529,189,380,0.497,13,52,0.25,176,328,0.537,0.514,91,129,0.705,174,213,387,89,48,50,44,113,482
Goga Bitadze,C,45,561,83,194,0.428,20,79,0.253,63,115,0.548,0.479,45,61,0.738,60,90,150,37,9,60,17,94,231
Bismack Biyombo,C,66,1349,142,242,0.587,0,1,0,142,241,0.589,0.587,47,105,0.448,137,210,347,81,17,74,71,141,331
Marques Bolden,C,6,29,1,3,0.333,0,0,,1,3,0.333,0.333,5,8,0.625,3,3,6,0,2,2,2,0,7
Chris Boucher,C,60,1453,288,560,0.514,90,235,0.383,198,325,0.609,0.595,152,193,0.788,117,287,404,63,35,111,46,166,818
Tony Bradley,C,42,684,131,197,0.665,0,3,0,131,194,0.675,0.665,38,55,0.691,85,154,239,37,15,30,33,61,300
Amida Brimah,C,5,29,5,8,0.625,0,0,,5,8,0.625,0.625,3,3,1,2,6,8,1,0,5,4,4,13
Moses Brown,C,43,920,146,268,0.545,0,0,,146,268,0.545,0.545,78,126,0.619,154,229,383,10,31,47,43,93,370
Thomas Bryant,C,10,271,59,91,0.648,9,21,0.429,50,70,0.714,0.698,16,24,0.667,18,43,61,15,4,8,11,31,143
Clint Capela,C,63,1898,413,695,0.594,0,0,,413,695,0.594,0.594,130,227,0.573,297,606,903,49,44,129,73,145,956
Vernon Carey Jr.,C,19,115,18,36,0.5,1,7,0.143,17,29,0.586,0.514,9,11,0.818,6,21,27,2,1,5,5,13,46
Wendell Carter Jr.,C,54,1375,230,457,0.503,15,51,0.294,215,406,0.53,0.52,131,179,0.732,132,311,443,104,35,42,78,146,606
Willie Cauley-Stein,C,53,906,115,182,0.632,1,11,0.091,114,171,0.667,0.635,49,78,0.628,66,170,236,35,21,43,29,129,280
Nic Claxton,C,32,594,90,145,0.621,1,5,0.2,89,140,0.636,0.624,31,64,0.484,43,123,166,28,23,40,18,68,212
DeMarcus Cousins,C,41,713,130,305,0.426,47,135,0.348,83,170,0.488,0.503,59,81,0.728,53,210,263,76,34,24,64,107,366
Ed Davis,C,23,299,19,44,0.432,0,0,,19,44,0.432,0.432,10,12,0.833,46,69,115,21,13,13,7,56,48
Dewayne Dedmon,C,16,210,46,65,0.708,1,5,0.2,45,60,0.75,0.715,20,27,0.741,28,58,86,12,9,6,13,36,113
Gorgui Dieng,C,38,552,85,163,0.521,30,70,0.429,55,93,0.591,0.613,58,67,0.866,40,100,140,48,26,16,32,56,258
Andre Drummond,C,46,1242,282,572,0.493,0,8,0,282,564,0.5,0.493,123,205,0.6,166,385,551,94,63,49,124,149,687
Joel Embiid,C,51,1585,461,899,0.513,58,154,0.377,403,745,0.541,0.545,471,548,0.859,113,426,539,145,50,69,159,123,1451
Drew Eubanks,C,54,755,116,205,0.566,2,2,1,114,203,0.562,0.571,77,106,0.726,74,167,241,42,18,49,45,88,311
Tacko Fall,C,19,136,21,29,0.724,0,0,,21,29,0.724,0.724,5,15,0.333,16,36,52,3,1,20,6,22,47
Derrick Favors,C,68,1039,155,243,0.638,0,2,0,155,241,0.643,0.638,59,80,0.738,138,238,376,44,32,68,36,143,369
Cristiano Felício,C,18,84,7,13,0.538,0,2,0,7,11,0.636,0.538,9,16,0.563,10,16,26,9,4,0,4,10,23
Bruno Fernando,C,33,226,18,44,0.409,0,2,0,18,42,0.429,0.409,15,22,0.682,16,62,78,10,4,3,21,23,51
Enes Freedom,C,72,1758,339,561,0.604,1,4,0.25,338,557,0.607,0.605,127,164,0.774,284,511,795,84,33,48,78,168,806
Marc Gasol,C,52,993,88,194,0.454,50,122,0.41,38,72,0.528,0.582,36,50,0.72,38,177,215,109,26,58,53,115,262
Taj Gibson,C,45,936,99,158,0.627,3,15,0.2,96,143,0.671,0.636,40,55,0.727,99,151,250,36,31,49,22,99,241
Harry Giles,C,38,348,42,97,0.433,8,23,0.348,34,74,0.459,0.474,16,27,0.593,31,102,133,29,8,13,20,54,108
Rudy Gobert,C,71,2187,391,579,0.675,0,4,0,391,575,0.68,0.675,233,374,0.623,240,720,960,89,40,190,118,163,1015
Jeff Green,C,68,1835,261,530,0.492,103,250,0.412,158,280,0.564,0.59,125,161,0.776,34,229,263,108,36,27,54,122,750
Montrezl Harrell,C,69,1580,375,603,0.622,0,10,0,375,593,0.632,0.622,181,256,0.707,158,270,428,73,46,49,74,128,931
Isaiah Hartenstein,C,46,559,94,171,0.55,2,6,0.333,92,165,0.558,0.556,46,71,0.648,65,116,181,55,19,39,44,104,236
Udonis Haslem,C,1,3,2,2,1,0,0,,2,2,1,1,0,0,,0,1,1,0,0,0,0,0,4
Jaxson Hayes,C,60,964,175,280,0.625,6,14,0.429,169,266,0.635,0.636,93,120,0.775,92,165,257,35,25,38,39,101,449
Willy Hernangómez,C,47,846,151,268,0.563,1,10,0.1,150,258,0.581,0.565,62,93,0.667,117,217,334,50,22,23,34,68,365
Richaun Holmes,C,61,1782,366,575,0.637,2,11,0.182,364,564,0.645,0.638,135,170,0.794,144,360,504,101,39,96,75,213,869
Al Horford,C,28,782,162,360,0.45,56,152,0.368,106,208,0.51,0.528,18,22,0.818,29,159,188,94,25,26,29,48,398
Dwight Howard,C,69,1196,178,303,0.587,5,20,0.25,173,283,0.611,0.596,121,210,0.576,190,390,580,61,30,62,112,200,482
Serge Ibaka,C,41,955,186,365,0.51,39,115,0.339,147,250,0.588,0.563,43,53,0.811,73,202,275,74,9,47,44,76,454
Jaren Jackson Jr.,C,11,258,53,125,0.424,17,60,0.283,36,65,0.554,0.492,35,42,0.833,17,45,62,12,12,18,15,42,158
Nikola Jokić,C,72,2488,732,1293,0.566,92,237,0.388,640,1056,0.606,0.602,342,394,0.868,205,575,780,599,95,48,222,192,1898
Damian Jones,C,39,547,70,103,0.68,1,5,0.2,69,98,0.704,0.684,42,58,0.724,36,85,121,29,11,29,26,77,183
DeAndre Jordan,C,57,1246,190,249,0.763,0,1,0,190,248,0.766,0.763,46,92,0.5,117,310,427,93,17,65,85,116,426
Frank Kaminsky,C,47,715,121,257,0.471,31,85,0.365,90,172,0.523,0.531,37,60,0.617,36,152,188,79,14,17,22,70,310
Alex Len,C,64,979,171,278,0.615,8,25,0.32,163,253,0.644,0.629,73,116,0.629,78,182,260,49,20,64,55,127,423
Meyers Leonard,C,3,29,3,7,0.429,3,7,0.429,0,0,,0.643,1,2,0.5,0,7,7,2,0,0,2,5,10
Kevon Looney,C,61,1161,108,197,0.548,4,17,0.235,104,180,0.578,0.558,31,48,0.646,117,205,322,119,21,22,37,136,251
Brook Lopez,C,70,1902,322,640,0.503,95,281,0.338,227,359,0.632,0.577,120,142,0.845,104,243,347,50,40,103,64,149,859
Robin Lopez,C,71,1354,269,425,0.633,5,18,0.278,264,407,0.649,0.639,99,137,0.723,141,131,272,55,15,44,75,109,642
Will Magnay,C,1,3,0,1,0,0,1,0,0,0,,0,0,0,,0,0,0,0,0,0,1,1,0
Thon Maker,C,8,76,10,18,0.556,0,2,0,10,16,0.625,0.556,10,11,0.909,8,10,18,4,2,4,3,7,30
Boban Marjanović,C,33,271,62,122,0.508,1,8,0.125,61,114,0.535,0.512,31,38,0.816,47,81,128,10,2,6,12,29,156
JaVale McGee,C,46,678,144,282,0.511,5,24,0.208,139,258,0.539,0.52,44,67,0.657,77,162,239,39,19,54,60,121,337
Chimezie Metu,C,36,488,91,179,0.508,13,37,0.351,78,142,0.549,0.545,31,43,0.721,31,81,112,28,14,18,29,59,226
Mike Muscala,C,35,645,119,267,0.446,68,184,0.37,51,83,0.614,0.573,33,36,0.917,19,113,132,28,8,11,21,54,339
Nerlens Noel,C,64,1547,137,223,0.614,0,3,0,137,220,0.623,0.614,50,70,0.714,142,266,408,46,70,141,65,176,324
Jusuf Nurkić,C,37,880,171,333,0.514,12,30,0.4,159,303,0.525,0.532,70,113,0.619,86,246,332,125,38,39,73,103,424
Jahlil Okafor,C,27,347,63,102,0.618,2,9,0.222,61,93,0.656,0.627,17,24,0.708,23,43,66,13,6,5,21,39,145
Onyeka Okongwu,C,50,601,96,149,0.644,0,3,0,96,146,0.658,0.644,36,57,0.632,62,101,163,18,23,33,29,100,228
Daniel Oturu,C,30,161,22,52,0.423,1,5,0.2,21,47,0.447,0.433,9,12,0.75,21,27,48,10,4,7,9,24,54
Anžejs Pasečņiks,C,1,6,0,1,0,0,1,0,0,0,,0,0,0,,1,0,1,1,0,0,5,2,0
Justin Patton,C,13,247,29,70,0.414,9,34,0.265,20,36,0.556,0.479,3,4,0.75,14,35,49,14,12,14,4,34,70
Norvel Pelle,C,13,84,8,15,0.533,0,0,,8,15,0.533,0.533,4,6,0.667,6,13,19,2,1,9,3,14,20
Mason Plumlee,C,56,1499,234,381,0.614,0,7,0,234,374,0.626,0.614,113,169,0.669,145,374,519,202,43,50,105,186,581
Jakob Poeltl,C,69,1845,265,430,0.616,0,0,,265,430,0.616,0.616,63,124,0.508,219,328,547,134,47,123,83,172,593
Vincent Poirier,C,10,39,3,12,0.25,0,1,0,3,11,0.273,0.25,2,6,0.333,6,8,14,2,0,3,4,8,8
Bobby Portis,C,66,1372,313,598,0.523,74,157,0.471,239,441,0.542,0.585,54,73,0.74,124,342,466,71,52,26,56,115,754
Kristaps Porziņģis,C,43,1327,325,683,0.476,97,258,0.376,228,425,0.536,0.547,118,138,0.855,82,299,381,68,20,58,51,115,865
Dwight Powell,C,58,966,120,194,0.619,5,21,0.238,115,173,0.665,0.631,97,124,0.782,80,154,234,63,36,30,40,135,342
Naz Reid,C,70,1347,304,581,0.523,61,174,0.351,243,407,0.597,0.576,115,166,0.693,82,240,322,72,34,76,69,179,784
Mitchell Robinson,C,31,853,115,176,0.653,0,0,,115,176,0.653,0.653,26,53,0.491,113,139,252,17,35,45,26,86,256
Dario Šarić,C,50,871,153,342,0.447,47,135,0.348,106,207,0.512,0.516,84,99,0.848,46,144,190,65,30,4,57,95,437
Ray Spalding,C,2,19,2,4,0.5,0,1,0,2,3,0.667,0.5,0,2,0,2,2,4,0,0,2,3,3,4
Isaiah Stewart,C,68,1455,226,409,0.553,21,63,0.333,205,346,0.592,0.578,64,92,0.696,159,294,453,59,39,86,67,184,537
Daniel Theis,C,65,1601,252,466,0.541,49,152,0.322,203,314,0.646,0.593,74,110,0.673,93,263,356,108,41,57,66,167,627
Killian Tillie,C,18,182,19,57,0.333,10,33,0.303,9,24,0.375,0.421,9,11,0.818,6,18,24,8,5,8,2,20,57
Karl-Anthony Towns,C,50,1689,425,875,0.486,122,315,0.387,303,560,0.541,0.555,267,311,0.859,133,396,529,225,39,57,160,186,1239
Myles Turner,C,47,1455,206,432,0.477,69,206,0.335,137,226,0.606,0.557,111,142,0.782,63,243,306,48,40,159,67,165,592
Jonas Valančiūnas,C,62,1755,440,743,0.592,21,57,0.368,419,686,0.611,0.606,157,203,0.773,253,523,776,112,35,57,100,179,1058
Anderson Varejão,C,5,36,4,16,0.25,0,1,0,4,15,0.267,0.25,5,9,0.556,7,13,20,3,0,2,1,3,13
Nikola Vučević,C,70,2348,666,1396,0.477,176,440,0.4,490,956,0.513,0.54,131,156,0.84,146,671,817,269,65,48,126,137,1639
Moritz Wagner,C,45,722,104,229,0.454,31,91,0.341,73,138,0.529,0.522,71,87,0.816,27,119,146,50,26,18,43,108,310
Hassan Whiteside,C,36,546,126,224,0.563,0,1,0,126,223,0.565,0.563,41,79,0.519,61,154,215,20,9,46,40,73,293
Robert Williams,C,52,985,186,258,0.721,0,2,0,186,256,0.727,0.721,45,73,0.616,133,225,358,94,43,91,52,105,417
James Wiseman,C,39,836,191,368,0.519,12,38,0.316,179,330,0.542,0.535,54,86,0.628,55,171,226,26,11,36,60,121,448
Christian Wood,C,41,1326,329,640,0.514,77,206,0.374,252,434,0.581,0.574,125,198,0.631,76,319,395,71,34,48,80,88,860
Cody Zeller,C,48,1005,181,324,0.559,4,28,0.143,177,296,0.598,0.565,85,119,0.714,119,209,328,86,27,17,51,121,451
Ivica Zubac,C,72,1609,257,394,0.652,1,4,0.25,256,390,0.656,0.654,135,171,0.789,189,330,519,90,24,62,81,187,650
Luke Kornet,C-PF,31,348,44,101,0.436,15,59,0.254,29,42,0.69,0.51,3,6,0.5,14,53,67,24,4,32,7,20,106
Kelly Olynyk,C-PF,70,1997,337,697,0.484,126,368,0.342,211,329,0.641,0.574,145,175,0.829,87,402,489,203,79,42,126,207,945
AVERAGE,C,43.03,922.69,167.77,307.13,0.52818,20.57,58.49,0.235786517,147.2,248.64,0.582453608,0.55612,71.69,99.4,0.692505155,84.68,197.15,281.83,64.68,24.38,41.56,49.08,94.46,427.8