Player,Pos,G,MP,FG,FGA,FG%,3P,3PA,3P%,2P,2PA,2P%,eFG%,FT,FTA,FT%,ORB,DRB,TRB,AST,STL,BLK,TOV,PF,PTS
Ty-Shon Alexander,SG,15,47,3,12,0.25,2,9,0.222,1,3,0.333,0.333,1,2,0.5,2,8,10,6,0,1,3,2,9
Nickeil Alexander-Walker,SG,46,1007,192,458,0.419,76,219,0.347,116,239,0.485,0.502,48,66,0.727,13,131,144,102,47,22,69,88,508
Grayson Allen,SG,50,1259,173,414,0.418,107,274,0.391,66,140,0.471,0.547,79,91,0.868,19,141,160,108,46,8,48,71,532
Dwayne Bacon,SG,72,1853,292,726,0.402,59,207,0.285,233,519,0.449,0.443,145,176,0.824,31,193,224,93,45,5,46,103,788
Desmond Bane,SG,68,1519,234,499,0.469,117,271,0.432,117,228,0.513,0.586,40,49,0.816,31,179,210,118,41,16,59,125,625
RJ Barrett,SG,72,2511,467,1060,0.441,124,309,0.401,343,751,0.457,0.499,206,276,0.746,68,346,414,217,53,20,139,188,1264
Bradley Beal,SG,60,2147,670,1382,0.485,130,373,0.349,540,1009,0.535,0.532,408,459,0.889,72,211,283,265,69,22,187,140,1878
Malik Beasley,SG,37,1214,264,600,0.44,128,321,0.399,136,279,0.487,0.547,68,80,0.85,28,134,162,88,30,7,60,62,724
Eric Bledsoe,SG,71,2111,307,730,0.421,121,355,0.341,186,375,0.496,0.503,134,195,0.687,29,215,244,268,55,24,114,112,869
Bogdan Bogdanović,SG,44,1305,267,565,0.473,146,333,0.438,121,232,0.522,0.602,40,44,0.909,20,140,160,147,49,13,54,99,720
Devin Booker,SG,67,2270,623,1287,0.484,126,371,0.34,497,916,0.543,0.533,340,392,0.867,34,247,281,289,53,16,207,181,1712
Avery Bradley,SG,27,602,64,171,0.374,33,101,0.327,31,70,0.443,0.471,12,15,0.8,8,49,57,46,21,3,28,55,173
Armoni Brooks,SG,20,520,78,192,0.406,60,157,0.382,18,35,0.514,0.563,7,12,0.583,10,58,68,30,12,5,22,34,223
Charlie Brown Jr.,SG,9,152,13,43,0.302,5,21,0.238,8,22,0.364,0.36,9,10,0.9,3,14,17,9,4,2,6,19,40
Jaylen Brown,SG,58,1999,538,1111,0.484,163,411,0.397,375,700,0.536,0.558,191,250,0.764,71,276,347,195,72,32,158,168,1430
Sterling Brown,SG,51,1229,150,335,0.448,91,215,0.423,59,120,0.492,0.584,25,31,0.806,38,186,224,72,38,12,41,97,416
Elijah Bryant,SG,1,32,6,13,0.462,1,5,0.2,5,8,0.625,0.5,3,3,1,2,4,6,3,0,1,4,4,16
Alec Burks,SG,49,1255,210,500,0.42,102,246,0.415,108,254,0.425,0.522,101,118,0.856,21,206,227,107,31,14,49,102,623
Kentavious Caldwell-Pope,SG,67,1902,218,506,0.431,120,293,0.41,98,213,0.46,0.549,97,112,0.866,27,152,179,127,62,26,66,114,653
Michael Carter-Williams,SG,31,800,105,270,0.389,15,61,0.246,90,209,0.431,0.417,49,80,0.613,39,100,139,129,25,17,69,81,274
Jordan Clarkson,SG,68,1818,457,1075,0.425,208,599,0.347,249,476,0.523,0.522,129,144,0.896,47,227,274,168,61,10,115,110,1251
Amir Coffey,SG,44,394,45,103,0.437,23,56,0.411,22,47,0.468,0.549,27,38,0.711,10,34,44,22,10,0,15,30,140
Pat Connaughton,SG,69,1575,168,387,0.434,101,272,0.371,67,115,0.583,0.565,31,40,0.775,63,269,332,81,49,23,33,99,468
Jarrett Culver,SG,34,499,69,168,0.411,13,53,0.245,56,115,0.487,0.449,29,48,0.604,34,70,104,24,17,9,28,58,180
Seth Curry,SG,57,1638,258,552,0.467,126,280,0.45,132,272,0.485,0.582,69,77,0.896,10,126,136,155,44,8,65,96,711
Nate Darling,SG,7,26,2,7,0.286,2,7,0.286,0,0,,0.429,3,3,1,1,0,1,1,0,1,1,1,9
Terence Davis,SG,61,1074,195,456,0.428,98,267,0.367,97,189,0.513,0.535,45,55,0.818,20,134,154,83,44,14,63,97,533
Spencer Dinwiddie,SG,3,64,6,16,0.375,2,7,0.286,4,9,0.444,0.438,6,6,1,0,13,13,9,2,1,5,4,20
Donte DiVincenzo,SG,66,1814,253,603,0.42,131,346,0.379,122,257,0.475,0.528,51,71,0.718,81,299,380,203,72,15,91,112,688
Luguentz Dort,SG,52,1543,247,639,0.387,113,329,0.343,134,310,0.432,0.475,122,164,0.744,38,151,189,88,45,19,79,134,729
Damyean Dotson,SG,46,907,119,293,0.406,46,159,0.289,73,134,0.545,0.485,24,36,0.667,5,88,93,91,16,4,42,42,308
PJ Dozier,SG,50,1088,148,355,0.417,47,149,0.315,101,206,0.49,0.483,42,66,0.636,35,147,182,92,31,22,46,86,385
Anthony Edwards,SG,72,2314,505,1211,0.417,171,520,0.329,334,691,0.483,0.488,211,272,0.776,59,277,336,211,82,36,160,129,1392
Carsen Edwards,SG,31,276,47,111,0.423,18,63,0.286,29,48,0.604,0.505,11,13,0.846,3,23,26,14,7,1,7,25,123
Wayne Ellington,SG,46,1012,149,338,0.441,116,275,0.422,33,63,0.524,0.612,28,35,0.8,12,73,85,67,18,9,33,59,442
Dante Exum,SG,6,116,10,26,0.385,2,11,0.182,8,15,0.533,0.423,1,2,0.5,2,15,17,13,4,2,7,9,23
Terrance Ferguson,SG,13,49,1,7,0.143,0,5,0,1,2,0.5,0.143,0,0,,0,1,1,2,1,0,4,7,2
Bryn Forbes,SG,70,1354,250,529,0.473,154,341,0.452,96,188,0.511,0.618,47,61,0.77,11,101,112,45,24,1,44,77,701
Langston Galloway,SG,40,438,66,147,0.449,36,85,0.424,30,62,0.484,0.571,22,23,0.957,7,35,42,26,8,0,13,25,190
Shai Gilgeous-Alexander,SG,35,1180,287,565,0.508,71,170,0.418,216,395,0.547,0.571,185,229,0.808,19,147,166,207,27,23,106,70,830
Eric Gordon,SG,27,789,159,367,0.433,69,210,0.329,90,157,0.573,0.527,94,114,0.825,8,50,58,71,14,13,51,44,481
Josh Green,SG,39,445,42,93,0.452,4,25,0.16,38,68,0.559,0.473,13,23,0.565,28,50,78,28,16,3,17,35,101
Tim Hardaway Jr.,SG,70,1985,407,911,0.447,207,529,0.391,200,382,0.524,0.56,142,174,0.816,20,209,229,126,31,11,64,111,1163
Gary Harris,SG,39,1080,138,345,0.4,48,141,0.34,90,204,0.441,0.47,64,78,0.821,21,58,79,78,28,11,37,71,388
Jalen Harris,SG,13,172,36,72,0.5,17,36,0.472,19,36,0.528,0.618,7,9,0.778,3,15,18,17,8,0,14,15,96
Shaquille Harrison,SG,34,333,26,78,0.333,3,16,0.188,23,62,0.371,0.353,18,22,0.818,7,41,48,25,17,5,11,33,73
Tyler Herro,SG,54,1635,307,699,0.439,107,297,0.36,200,402,0.498,0.516,94,117,0.803,25,243,268,184,35,17,101,71,815
Buddy Hield,SG,71,2433,403,992,0.406,282,721,0.391,121,271,0.446,0.548,88,104,0.846,29,305,334,257,63,30,130,175,1176
Nate Hinton,SG,21,93,15,42,0.357,4,19,0.211,11,23,0.478,0.405,7,10,0.7,1,8,9,8,7,2,5,8,41
Justin Holiday,SG,72,2183,258,625,0.413,173,453,0.382,85,172,0.494,0.551,67,85,0.788,32,224,256,119,74,41,54,135,756
Talen Horton-Tucker,SG,65,1304,224,489,0.458,37,131,0.282,187,358,0.522,0.496,100,129,0.775,25,144,169,181,63,21,105,127,585
Markus Howard,SG,37,205,40,106,0.377,18,65,0.277,22,41,0.537,0.462,7,9,0.778,1,20,21,18,4,1,18,23,105
Kevin Huerter,SG,69,2126,316,731,0.432,140,386,0.363,176,345,0.51,0.528,50,64,0.781,38,193,231,241,82,18,79,165,822
Josh Jackson,SG,62,1560,296,707,0.419,77,257,0.3,219,450,0.487,0.473,159,218,0.729,57,197,254,143,53,47,142,178,828
Reggie Jackson,SG,67,1544,263,585,0.45,122,282,0.433,141,303,0.465,0.554,67,82,0.817,24,168,192,205,41,7,74,127,715
DaQuan Jeffries,SG,31,493,50,120,0.417,20,67,0.299,30,53,0.566,0.5,7,8,0.875,19,52,71,22,15,10,14,48,127
Ty Jerome,SG,33,788,128,287,0.446,71,168,0.423,57,119,0.479,0.57,26,34,0.765,10,81,91,120,20,6,47,61,353
Isaiah Joe,SG,41,383,48,133,0.361,39,106,0.368,9,27,0.333,0.508,18,24,0.75,6,30,36,20,12,4,11,34,153
Tyler Johnson,SG,39,684,72,183,0.393,48,132,0.364,24,51,0.471,0.525,18,21,0.857,6,71,77,47,14,0,17,43,210
Mason Jones,SG,32,334,52,123,0.423,24,66,0.364,28,57,0.491,0.52,40,64,0.625,7,48,55,42,7,1,29,24,168
Luke Kennard,SG,63,1232,197,414,0.476,100,224,0.446,97,190,0.511,0.597,26,31,0.839,15,146,161,104,23,9,48,91,520
John Konchar,SG,43,575,69,138,0.5,21,56,0.375,48,82,0.585,0.576,25,30,0.833,35,93,128,47,30,9,18,40,184
Furkan Korkmaz,SG,55,1062,170,424,0.401,101,269,0.375,69,155,0.445,0.52,60,82,0.732,17,96,113,82,49,9,46,64,501
Jeremy Lamb,SG,36,765,120,276,0.435,52,128,0.406,68,148,0.459,0.529,71,75,0.947,25,106,131,53,34,23,22,72,363
Romeo Langford,SG,18,283,21,59,0.356,5,18,0.278,16,41,0.39,0.398,9,12,0.75,12,23,35,13,6,5,10,24,56
Zach LaVine,SG,58,2034,569,1123,0.507,200,477,0.419,369,646,0.571,0.596,253,298,0.849,36,253,289,282,46,27,203,138,1591
Damion Lee,SG,57,1079,128,274,0.467,77,194,0.397,51,80,0.638,0.608,40,44,0.909,22,158,180,73,38,8,30,89,373
Caris LeVert,SG,47,1486,359,814,0.441,84,258,0.326,275,556,0.495,0.493,146,180,0.811,33,181,214,245,66,30,102,105,948
Terance Mann,SG,67,1263,178,350,0.509,38,91,0.418,140,259,0.541,0.563,78,94,0.83,56,186,242,104,29,13,40,126,472
Garrison Mathews,SG,64,1038,97,237,0.409,76,198,0.384,21,39,0.538,0.57,84,95,0.884,16,71,87,26,29,7,10,106,354
Dakota Mathias,SG,8,123,19,48,0.396,8,26,0.308,11,22,0.5,0.479,2,6,0.333,1,6,7,13,1,3,1,7,48
Wesley Matthews,SG,58,1130,89,252,0.353,66,197,0.335,23,55,0.418,0.484,35,41,0.854,20,73,93,54,38,17,26,80,279
Tyrese Maxey,SG,61,935,198,429,0.462,31,103,0.301,167,326,0.512,0.498,61,70,0.871,11,93,104,120,26,13,41,79,488
Skylar Mays,SG,33,269,44,98,0.449,14,40,0.35,30,58,0.517,0.52,22,25,0.88,10,25,35,30,14,2,9,15,124
CJ McCollum,SG,47,1600,405,884,0.458,169,420,0.402,236,464,0.509,0.554,108,133,0.812,30,155,185,223,44,21,65,87,1087
Rodney McGruder,SG,16,194,37,70,0.529,11,24,0.458,26,46,0.565,0.607,6,8,0.75,8,14,22,16,8,1,7,12,91
Ben McLemore,SG,53,905,135,365,0.37,97,280,0.346,38,85,0.447,0.503,39,53,0.736,15,85,100,39,23,9,42,88,406
Sam Merrill,SG,30,233,32,72,0.444,21,47,0.447,11,25,0.44,0.59,4,4,1,6,24,30,21,8,1,10,17,89
Shake Milton,SG,63,1461,300,667,0.45,71,203,0.35,229,464,0.494,0.503,146,176,0.83,33,115,148,193,39,18,103,130,817
Adam Mokoka,SG,14,56,7,19,0.368,1,10,0.1,6,9,0.667,0.395,0,1,0,1,4,5,5,2,1,5,5,15
Malik Monk,SG,42,878,173,399,0.434,85,212,0.401,88,187,0.471,0.54,59,72,0.819,14,87,101,87,19,4,55,47,490
E'Twaun Moore,SG,27,389,55,121,0.455,11,35,0.314,44,86,0.512,0.5,12,14,0.857,14,31,45,40,15,5,23,32,133
Jaylen Nowell,SG,42,759,142,335,0.424,50,150,0.333,92,185,0.497,0.499,45,55,0.818,19,76,95,62,22,12,28,72,379
Josh Okogie,SG,59,1197,102,254,0.402,29,108,0.269,73,146,0.5,0.459,83,108,0.769,63,93,156,63,54,28,43,123,316
Isaac Okoro,SG,67,2173,235,559,0.42,62,214,0.29,173,345,0.501,0.476,114,157,0.726,68,138,206,128,62,24,86,185,646
Victor Oladipo,SG,33,1080,235,576,0.408,78,239,0.326,157,337,0.466,0.476,104,138,0.754,12,148,160,151,46,14,83,81,652
Miye Oni,SG,54,519,35,99,0.354,30,88,0.341,5,11,0.455,0.505,5,6,0.833,23,61,84,28,11,8,16,61,105
Theo Pinson,SG,17,34,1,9,0.111,0,8,0,1,1,1,0.111,0,0,,0,5,5,1,0,0,1,4,2
Jordan Poole,SG,51,988,205,474,0.432,97,276,0.351,108,198,0.545,0.535,105,119,0.882,15,77,92,99,26,9,51,86,612
Kevin Porter Jr.,SG,26,835,156,367,0.425,50,161,0.311,106,206,0.515,0.493,69,94,0.734,20,79,99,164,19,8,91,61,431
Payton Pritchard,SG,66,1268,184,418,0.44,102,248,0.411,82,170,0.482,0.562,40,45,0.889,33,125,158,120,37,9,53,104,510
Jahmi'us Ramsey,SG,13,94,15,38,0.395,5,19,0.263,10,19,0.526,0.461,5,5,1,2,8,10,6,4,1,3,8,40
J.J. Redick,SG,44,723,106,267,0.397,66,178,0.371,40,89,0.449,0.521,49,52,0.942,4,60,64,51,11,3,36,50,327
Josh Richardson,SG,59,1790,264,618,0.427,88,267,0.33,176,351,0.501,0.498,99,108,0.917,51,144,195,153,61,24,79,130,715
Austin Rivers,SG,36,845,104,245,0.424,55,149,0.369,49,96,0.51,0.537,22,31,0.71,8,74,82,81,30,2,36,64,285
Andre Roberson,SG,5,63,2,14,0.143,1,8,0.125,1,6,0.167,0.179,1,2,0.5,7,8,15,4,3,1,2,4,6
Jerome Robinson,SG,17,305,28,95,0.295,11,42,0.262,17,53,0.321,0.353,16,20,0.8,4,34,38,25,12,6,19,31,83
Terrence Ross,SG,46,1347,254,616,0.412,89,264,0.337,165,352,0.469,0.485,120,138,0.87,15,143,158,108,47,21,74,88,717
Terry Rozier,SG,69,2383,510,1134,0.45,222,571,0.389,288,563,0.512,0.548,165,202,0.817,47,255,302,293,87,26,128,119,1407
Tomáš Satoranský,SG,58,1307,169,329,0.514,42,118,0.356,127,211,0.602,0.578,67,79,0.848,30,112,142,271,40,14,96,89,447
Dennis Schröder,SG,61,1956,332,760,0.437,71,212,0.335,261,548,0.476,0.484,206,243,0.848,30,181,211,351,70,13,163,159,941
Jay Scrubb,SG,4,84,14,36,0.389,2,9,0.222,12,27,0.444,0.417,5,5,1,2,12,14,1,4,0,7,5,35
Collin Sexton,SG,60,2115,525,1105,0.475,98,264,0.371,427,841,0.508,0.519,312,383,0.815,58,129,187,262,62,10,167,157,1460
Landry Shamet,SG,61,1403,186,456,0.408,129,333,0.387,57,123,0.463,0.549,66,78,0.846,11,101,112,99,31,10,48,93,567
Iman Shumpert,SG,2,11,1,4,0.25,0,3,0,1,1,1,0.25,0,0,,1,0,1,0,1,0,1,0,2
Anfernee Simons,SG,64,1104,168,401,0.419,120,282,0.426,48,119,0.403,0.569,46,57,0.807,14,126,140,89,18,8,43,96,502
Deividas Sirvydis,SG,20,133,14,40,0.35,10,28,0.357,4,12,0.333,0.475,3,6,0.5,0,29,29,5,2,0,5,9,41
Tony Snell,SG,47,992,88,171,0.515,62,109,0.569,26,62,0.419,0.696,11,11,1,18,94,112,59,13,11,21,75,249
Cassius Stanley,SG,24,93,13,43,0.302,3,13,0.231,10,30,0.333,0.337,7,9,0.778,8,12,20,1,1,2,1,14,36
Edmond Sumner,SG,53,861,148,282,0.525,35,88,0.398,113,194,0.582,0.587,68,83,0.819,18,76,94,49,33,10,51,88,399
Garrett Temple,SG,56,1528,158,381,0.415,67,200,0.335,91,181,0.503,0.503,40,50,0.8,29,131,160,124,43,30,58,126,423
Brodric Thomas,SG,32,399,39,108,0.361,16,59,0.271,23,49,0.469,0.435,31,46,0.674,8,45,53,30,15,10,22,40,125
Khyri Thomas,SG,5,153,32,66,0.485,9,27,0.333,23,39,0.59,0.553,9,9,1,7,11,18,25,9,6,6,8,82
Matt Thomas,SG,45,326,50,127,0.394,27,80,0.338,23,47,0.489,0.5,12,14,0.857,7,37,44,19,4,0,14,18,139
Sindarius Thornwell,SG,21,217,15,46,0.326,7,23,0.304,8,23,0.348,0.402,4,8,0.5,3,15,18,21,13,2,7,15,41
Matisse Thybulle,SG,65,1298,102,243,0.42,43,143,0.301,59,100,0.59,0.508,8,18,0.444,30,94,124,63,105,71,32,127,255
Juan Toscano-Anderson,SG,53,1107,121,209,0.579,37,92,0.402,84,117,0.718,0.667,22,31,0.71,29,205,234,150,41,26,61,111,301
Gary Trent Jr.,SG,58,1802,320,785,0.408,165,429,0.385,155,356,0.435,0.513,83,106,0.783,27,125,152,80,56,10,43,92,888
Denzel Valentine,SG,62,1036,155,416,0.373,80,242,0.331,75,174,0.431,0.469,16,17,0.941,24,173,197,105,30,7,42,70,406
Fred VanVleet,SG,52,1899,338,870,0.389,174,476,0.366,164,394,0.416,0.489,169,191,0.885,32,188,220,328,87,37,95,119,1019
Lonnie Walker IV,SG,60,1522,256,609,0.42,100,282,0.355,156,327,0.477,0.502,57,70,0.814,14,141,155,101,29,15,65,101,669
Quinndary Weatherspoon,SG,20,121,16,35,0.457,1,6,0.167,15,29,0.517,0.471,13,16,0.813,3,8,11,8,8,2,10,18,46
Derrick White,SG,36,1064,186,453,0.411,84,243,0.346,102,210,0.486,0.503,97,114,0.851,13,94,107,127,26,36,45,91,553
R.J. Hampton,SG-PG,51,888,136,313,0.435,27,87,0.31,109,226,0.482,0.478,55,82,0.671,29,150,179,87,21,10,53,61,354
Delon Wright,SG-PG,63,1748,240,518,0.463,64,172,0.372,176,346,0.509,0.525,101,126,0.802,65,204,269,278,101,30,83,75,645
Hamidou Diallo,SG-SF,52,1226,224,470,0.477,28,82,0.341,196,388,0.505,0.506,128,200,0.64,59,213,272,101,41,24,76,134,604
Norman Powell,SG-SF,69,2205,438,918,0.477,171,416,0.411,267,502,0.532,0.57,236,271,0.871,42,173,215,129,82,18,119,160,1283
AVERAGE,SG,44.24409449,1019.472441,172.4409449,393.6614173,0.415811024,68.97637795,186.3858268,0.335559055,103.4645669,207.2755906,0.497507937,0.501220472,65.92125984,81.73228346,0.787975806,22.22047244,109.1259843,131.3464567,97.18897638,31.68503937,12.24409449,51.8503937,74.95275591,479.7795276