Player,Pos,G,MP,FG,FGA,FG%,3P,3PA,3P%,2P,2PA,2P%,eFG%,FT,FTA,FT%,ORB,DRB,TRB,AST,STL,BLK,TOV,PF,PTS
Thanasis Antetokounmpo,SF,57,551,67,137,0.489,7,29,0.241,60,108,0.556,0.515,25,49,0.51,54,70,124,46,22,10,43,74,166
OG Anunoby,SF,43,1433,249,519,0.48,104,261,0.398,145,258,0.562,0.58,80,102,0.784,54,183,237,94,66,32,75,114,682
Trevor Ariza,SF,30,841,99,241,0.411,50,143,0.35,49,98,0.5,0.515,34,44,0.773,27,117,144,55,31,18,21,55,282
Deni Avdija,SF,54,1257,130,312,0.417,53,168,0.315,77,144,0.535,0.502,29,45,0.644,22,240,262,63,32,15,33,140,342
Will Barton,SF,56,1736,259,608,0.426,98,257,0.381,161,351,0.459,0.507,95,121,0.785,39,187,226,181,50,23,96,95,711
Keita Bates-Diop,SF,30,245,30,67,0.448,5,17,0.294,25,50,0.5,0.485,14,21,0.667,9,40,49,12,11,5,7,11,79
Nicolas Batum,SF,67,1835,191,412,0.464,110,272,0.404,81,140,0.579,0.597,48,58,0.828,50,266,316,148,69,37,53,102,540
Kent Bazemore,SF,67,1333,176,392,0.449,75,184,0.408,101,208,0.486,0.545,54,78,0.692,26,203,229,108,69,33,82,158,481
DeAndre' Bembry,SF,51,972,117,228,0.513,14,53,0.264,103,175,0.589,0.544,45,66,0.682,33,113,146,107,53,18,71,87,293
Saddiq Bey,SF,70,1909,279,691,0.404,175,460,0.38,104,231,0.45,0.53,124,147,0.844,43,275,318,95,52,14,60,110,857
Tyler Bey,SF,18,71,7,22,0.318,1,4,0.25,6,18,0.333,0.341,3,5,0.6,8,11,19,3,0,1,3,6,18
Keljin Blevins,SF,17,75,5,20,0.25,2,8,0.25,3,12,0.25,0.3,0,0,,3,7,10,4,2,0,5,8,12
Bojan Bogdanović,SF,72,2216,406,925,0.439,180,461,0.39,226,464,0.487,0.536,233,265,0.879,40,241,281,136,45,4,128,115,1225
Isaac Bonga,SF,40,432,30,81,0.37,13,47,0.277,17,34,0.5,0.451,5,8,0.625,18,48,66,23,11,9,22,63,78
Brian Bowen,SF,6,15,1,4,0.25,0,1,0,1,3,0.333,0.25,1,1,1,0,3,3,0,0,0,0,1,3
Ignas Brazdeikis,SF,13,249,35,83,0.422,11,28,0.393,24,55,0.436,0.488,10,14,0.714,11,34,45,17,4,3,12,22,91
Mikal Bridges,SF,72,2348,363,669,0.543,134,315,0.425,229,354,0.647,0.643,110,131,0.84,76,233,309,152,76,63,57,116,970
Oshae Brissett,SF,21,519,73,151,0.483,33,78,0.423,40,73,0.548,0.593,50,65,0.769,29,86,115,18,19,20,10,32,229
Dillon Brooks,SF,67,1997,432,1031,0.419,128,372,0.344,304,659,0.461,0.481,159,195,0.815,53,143,196,157,78,26,119,237,1151
Troy Brown Jr.,SF,34,524,62,144,0.431,22,70,0.314,40,74,0.541,0.507,15,21,0.714,20,85,105,29,10,6,21,49,161
Reggie Bullock,SF,65,1949,248,561,0.442,163,398,0.41,85,163,0.521,0.587,50,55,0.909,16,207,223,99,52,11,45,146,709
Jimmy Butler,SF,52,1745,366,736,0.497,25,102,0.245,341,634,0.538,0.514,359,416,0.863,94,265,359,369,108,18,109,71,1116
Torrey Craig,SF,50,803,109,227,0.48,39,106,0.368,70,121,0.579,0.566,17,22,0.773,57,140,197,49,28,26,25,83,274
CJ Elleby,SF,30,192,25,66,0.379,7,34,0.206,18,32,0.563,0.432,11,15,0.733,11,21,32,10,6,3,5,27,68
James Ennis III,SF,41,986,115,243,0.473,45,104,0.433,70,139,0.504,0.566,70,87,0.805,43,123,166,62,32,7,36,84,345
Paul George,SF,54,1821,445,953,0.467,171,416,0.411,274,537,0.51,0.557,198,228,0.868,45,314,359,280,62,24,179,132,1259
Jerami Grant,SF,54,1829,400,932,0.429,115,329,0.35,285,603,0.473,0.491,290,343,0.845,35,215,250,152,35,58,109,125,1205
Danny Green,SF,69,1934,224,544,0.412,175,432,0.405,49,112,0.438,0.573,31,40,0.775,55,205,260,118,92,56,67,125,654
Josh Hall,SF,21,336,30,99,0.303,4,37,0.108,26,62,0.419,0.323,22,44,0.5,6,53,59,28,4,1,25,37,86
Joe Harris,SF,69,2141,357,707,0.505,211,444,0.475,146,263,0.555,0.654,49,63,0.778,43,205,248,130,46,14,62,141,974
Josh Hart,SF,47,1349,151,344,0.439,63,193,0.326,88,151,0.583,0.531,69,89,0.775,53,324,377,109,38,12,49,111,434
Gordon Hayward,SF,44,1496,311,658,0.473,85,205,0.415,226,453,0.499,0.537,156,185,0.843,37,221,258,181,52,14,91,74,863
Jaylen Hoard,SF,19,320,44,88,0.5,0,11,0,44,77,0.571,0.5,28,41,0.683,21,44,65,24,13,5,17,19,116
Rodney Hood,SF,55,942,94,260,0.362,34,113,0.301,60,147,0.408,0.427,24,28,0.857,23,80,103,53,24,7,36,74,246
Danuel House Jr.,SF,36,932,110,272,0.404,54,156,0.346,56,116,0.483,0.504,41,63,0.651,18,114,132,69,20,16,36,67,315
Elijah Hughes,SF,18,64,10,30,0.333,8,23,0.348,2,7,0.286,0.467,3,4,0.75,1,8,9,6,1,1,6,1,31
De'Andre Hunter,SF,23,678,120,248,0.484,31,95,0.326,89,153,0.582,0.546,73,85,0.859,17,93,110,44,19,12,29,59,344
Chandler Hutchison,SF,25,346,39,103,0.379,8,22,0.364,31,81,0.383,0.417,21,25,0.84,6,72,78,17,12,5,20,33,107
Andre Iguodala,SF,63,1339,95,248,0.383,60,182,0.33,35,66,0.53,0.504,25,38,0.658,38,183,221,142,57,35,67,90,275
Joe Ingles,SF,67,1867,275,562,0.489,183,406,0.451,92,156,0.59,0.652,76,90,0.844,27,217,244,318,45,12,117,120,809
Brandon Ingram,SF,61,2093,513,1101,0.466,143,375,0.381,370,726,0.51,0.531,281,320,0.878,34,265,299,296,42,36,154,124,1450
Wes Iwundu,SF,41,539,34,102,0.333,5,41,0.122,29,61,0.475,0.358,26,31,0.839,15,75,90,18,15,4,19,49,99
Justin Jackson,SF,34,577,89,221,0.403,36,117,0.308,53,104,0.51,0.484,31,37,0.838,16,61,77,52,15,2,32,32,245
Justin James,SF,36,310,52,111,0.468,14,38,0.368,38,73,0.521,0.532,21,36,0.583,9,21,30,22,8,3,15,23,139
Keldon Johnson,SF,69,1968,338,705,0.479,60,181,0.331,278,524,0.531,0.522,145,196,0.74,93,319,412,121,40,24,78,142,881
Derrick Jones Jr.,SF,58,1318,147,304,0.484,43,136,0.316,104,168,0.619,0.554,59,91,0.648,77,128,205,47,37,54,32,127,396
Louis King,SF,6,85,17,34,0.5,4,11,0.364,13,23,0.565,0.559,6,6,1,5,13,18,9,7,3,4,9,44
Kevin Knox,SF,42,464,56,143,0.392,35,89,0.393,21,54,0.389,0.514,16,20,0.8,10,51,61,19,12,6,17,37,163
Kyle Kuzma,SF,68,1954,335,757,0.443,137,380,0.361,198,377,0.525,0.533,67,97,0.691,108,309,417,127,35,41,113,121,874
Anthony Lamb,SF,24,415,46,118,0.39,23,71,0.324,23,47,0.489,0.487,18,21,0.857,27,43,70,23,6,5,19,34,133
Jake Layman,SF,45,627,91,184,0.495,23,78,0.295,68,106,0.642,0.557,26,37,0.703,13,54,67,28,29,19,26,44,231
Kawhi Leonard,SF,52,1773,465,908,0.512,101,254,0.398,364,654,0.557,0.568,261,295,0.885,55,282,337,269,81,21,105,82,1292
Didi Louzada,SF,3,56,3,13,0.231,2,8,0.25,1,5,0.2,0.308,0,0,,1,2,3,3,2,0,3,5,8
Timothé Luwawu-Cabarrot,SF,58,1050,130,356,0.365,75,239,0.314,55,117,0.47,0.471,35,43,0.814,28,101,129,69,33,6,43,99,370
Naji Marshall,SF,32,700,82,209,0.392,29,83,0.349,53,126,0.421,0.462,53,75,0.707,15,133,148,88,26,10,38,58,246
Caleb Martin,SF,53,818,96,256,0.375,31,125,0.248,65,131,0.496,0.436,41,64,0.641,31,110,141,67,37,12,33,62,264
Cody Martin,SF,52,849,83,188,0.441,16,58,0.276,67,130,0.515,0.484,25,43,0.581,52,109,161,86,37,12,40,52,207
Kelan Martin,SF,35,322,62,138,0.449,24,60,0.4,38,78,0.487,0.536,9,10,0.9,18,60,78,17,10,10,16,35,157
Kenyon Martin Jr.,SF,45,1068,162,318,0.509,35,96,0.365,127,222,0.572,0.564,60,84,0.714,73,169,242,48,30,41,38,89,419
Patrick McCaw,SF,5,33,1,1,1,0,0,,1,1,1,1,3,3,1,1,2,3,4,2,0,0,6,5
Jalen McDaniels,SF,47,904,133,284,0.468,35,105,0.333,98,179,0.547,0.53,45,64,0.703,45,124,169,53,28,19,45,95,346
Sean McDermott,SF,18,158,13,33,0.394,5,22,0.227,8,11,0.727,0.47,8,8,1,6,13,19,4,2,3,4,8,39
Alfonzo McKinnie,SF,39,258,48,93,0.516,16,39,0.41,32,54,0.593,0.602,10,18,0.556,22,32,54,6,7,0,5,26,122
Khris Middleton,SF,68,2269,511,1074,0.476,151,365,0.414,360,709,0.508,0.546,212,236,0.898,54,352,406,370,74,9,178,160,1385
Darius Miller,SF,18,197,22,48,0.458,17,42,0.405,5,6,0.833,0.635,12,12,1,2,22,24,21,13,5,8,13,73
Abdel Nader,SF,24,355,57,116,0.491,18,43,0.419,39,73,0.534,0.569,28,37,0.757,7,55,62,19,10,9,19,34,160
Aaron Nesmith,SF,46,669,78,178,0.438,40,108,0.37,38,70,0.543,0.551,22,28,0.786,28,99,127,23,15,9,23,87,218
James Nunnally,SF,9,48,5,13,0.385,4,12,0.333,1,1,1,0.538,1,2,0.5,2,7,9,3,0,0,2,1,15
David Nwaba,SF,30,679,106,218,0.486,17,63,0.27,89,155,0.574,0.525,47,68,0.691,40,78,118,31,30,21,17,60,276
Jordan Nwora,SF,30,274,62,135,0.459,28,62,0.452,34,73,0.466,0.563,19,25,0.76,9,51,60,7,16,7,24,22,171
Royce O'Neale,SF,71,2241,175,394,0.444,107,278,0.385,68,116,0.586,0.58,39,46,0.848,88,397,485,181,57,32,83,182,496
Cameron Oliver,SF,4,87,19,33,0.576,4,13,0.308,15,20,0.75,0.636,1,4,0.25,5,16,21,5,2,4,3,11,43
Cedi Osman,SF,59,1510,219,586,0.374,99,324,0.306,120,262,0.458,0.458,76,95,0.8,38,163,201,174,53,9,80,119,613
Kelly Oubre Jr.,SF,55,1687,318,724,0.439,90,285,0.316,228,439,0.519,0.501,123,177,0.695,82,247,329,73,57,42,70,121,849
Michael Porter Jr.,SF,61,1912,443,817,0.542,170,382,0.445,273,435,0.628,0.646,106,134,0.791,91,354,445,70,40,54,77,126,1162
Cam Reddish,SF,26,750,96,263,0.365,33,126,0.262,63,137,0.46,0.428,67,82,0.817,22,82,104,35,33,9,34,68,292
Cameron Reynolds,SF,5,40,6,18,0.333,3,12,0.25,3,6,0.5,0.417,0,0,,2,3,5,2,0,0,0,2,15
Duncan Robinson,SF,72,2262,315,717,0.439,250,613,0.408,65,104,0.625,0.614,62,75,0.827,7,243,250,127,43,20,81,181,942
Glenn Robinson III,SF,23,369,42,99,0.424,16,44,0.364,26,55,0.473,0.505,21,23,0.913,11,34,45,20,4,3,11,23,121
Max Strus,SF,39,507,85,187,0.455,50,148,0.338,35,39,0.897,0.588,16,24,0.667,5,36,41,24,11,2,8,43,236
Jae'Sean Tate,SF,70,2043,316,625,0.506,60,195,0.308,256,430,0.595,0.554,102,147,0.694,132,242,374,178,85,36,98,222,794
Jayson Tatum,SF,64,2290,605,1318,0.459,187,485,0.386,418,833,0.502,0.53,295,340,0.868,50,422,472,276,75,31,171,122,1692
Axel Toupane,SF,8,61,4,11,0.364,1,2,0.5,3,9,0.333,0.409,5,7,0.714,0,6,6,4,2,3,0,6,14
Devin Vassell,SF,62,1056,123,303,0.406,52,150,0.347,71,153,0.464,0.492,43,51,0.843,24,150,174,56,43,18,22,88,341
T.J. Warren,SF,4,117,27,51,0.529,0,7,0,27,44,0.614,0.529,8,10,0.8,2,12,14,5,2,0,4,16,62
Yuta Watanabe,SF,50,723,79,180,0.439,36,90,0.4,43,90,0.478,0.539,24,29,0.828,36,123,159,40,26,19,19,57,218
Paul Watson,SF,27,297,38,82,0.463,30,64,0.469,8,18,0.444,0.646,5,8,0.625,4,41,45,17,6,3,9,36,111
Dylan Windler,SF,31,513,57,130,0.438,26,77,0.338,31,53,0.585,0.538,21,27,0.778,20,87,107,33,19,12,32,37,161
Justise Winslow,SF,26,507,74,210,0.352,10,54,0.185,64,156,0.41,0.376,20,35,0.571,18,100,118,50,15,12,37,47,178
Robert Woodard II,SF,13,45,8,20,0.4,1,6,0.167,7,14,0.5,0.425,3,8,0.375,4,12,16,2,0,3,1,4,20
Tyler Cook,SF-PF,32,438,69,103,0.67,1,2,0.5,68,101,0.673,0.675,17,35,0.486,28,67,95,17,8,2,21,35,156
Rodions Kurucs,SF-PF,21,125,11,32,0.344,6,21,0.286,5,11,0.455,0.438,3,4,0.75,5,18,23,10,9,4,13,16,31
Otto Porter Jr.,SF-PF,28,606,98,227,0.432,39,104,0.375,59,123,0.48,0.518,36,42,0.857,28,124,152,55,16,4,25,41,271
Evan Fournier,SF-SG,42,1259,247,541,0.457,117,283,0.413,130,258,0.504,0.565,108,137,0.788,10,118,128,144,47,19,73,96,719
Javonte Green,SF-SG,41,473,53,102,0.52,10,30,0.333,43,72,0.597,0.569,30,40,0.75,26,45,71,17,28,6,19,45,146
Svi Mykhailiuk,SF-SG,66,1324,208,506,0.411,105,314,0.334,103,192,0.536,0.515,38,50,0.76,24,139,163,110,51,12,88,63,559
AVERAGE,SF,40.98958333,934.3645833,147.40625,325.5833333,0.441020833,55.89583333,150.4791667,0.333031579,91.51041667,175.1041667,0.527625,0.5201875,58.36458333,73.27083333,0.756333333,30.40625,126.1458333,156.5520833,76.90625,29.96875,14.83333333,44.55208333,70.38541667,409.0729167